5 5 5 5 5 5 5 5 0 0 0 0 0 0 0 0 0 0 0 0
5 2 2 2 2 5 5 5 0 0 0 0 0 0 0 0 0 0 0 0
5 2 3 0 2 5 5 5 0 0 0 0 0 0 0 0 0 0 0 0
5 2 0 0 2 5 5 5 0 0 0 0 0 0 0 0 0 0 0 0
5 2 2 2 2 5 5 5 0 0 0 0 0 0 0 0 0 0 0 0
5 5 5 5 5 5 5 5 0 0 0 0 0 0 0 0 0 0 0 0
0 0 0 0 0 0 0 0 0 0 0 0 0 0 0 0 0 0 0 4
0 0 0 0 0 0 0 0 0 0 0 0 0 0 0 0 0 0 0 0
0 0 0 0 0 0 0 0 0 0 0 0 0 0 0 0 0 0 0 0
0 0 0 0 0 0 0 0 0 0 0 0 0 0 0 0 0 0 0 0
